...................................................................................................
...................................................................................................
....###########################################################################################....
....#.........................................................................................#....
....#.........................................................................................#....
....#.........................................................................................#....
....#.........................................................................................#....
....#.........................................................................................#....
....#.........................................................................................#....
....#........o................................................................................#....
....#.........................................................................................#....
....#.........................................................................................#....
....#.........................................................................................#....
....#.........................................................................................#....
....#.........................................................................................#....
....#.........................................................................................#....
....#.........................................................................................#....
....#.........................................................................................#....
....#.........................................................................................#....
....#.........................................................................................#....
....#.........................................................................................#....
....#.........................................................................................#....
....#.........................................................................................#....
....#.........................................................................................#....
....#.........................................................................................#....
....#.........................................................................................#....
....#.........................................................................................#....
....#.........................................................................................#....
....#.........................................................................................#....
....#.........................................................................................#....
....#.........................................................................@...............#....
....#.........................................................................................#....
....#.........................................................................................#....
....#.........................................................................................#....
....#.........................................................................................#....
....#.........................................................................................#....
....###########################################################################################....
...................................................................................................
...................................................................................................
