...................................................................................................
...................................................................................................
....###########################################################################################....
....#.......................#.................................................................#....
....#.......................#.................................................................#....
....#.......................#.................................................................#....
....#.......................#.................................................................#....
....#...........@...........#...........o.....................................................#....
....#.......................#.................................................................#....
....#.......................#.................................................................#....
....#.......................#.................................................................#....
....#.......................#.................................................................#....
....#.......................#.................................................................#....
....#.......................#.................................................................#....
....#.......................#.................................................................#....
....#.......................#.................................................................#....
....#.......................#.................................................................#....
....#.......................#.................................................................#....
....#.......................#.................................................................#....
....#.......................#.................................................................#....
....#.......................#.................................................................#....
....#.......................########################################..........................#....
....#.........................................................................................#....
....#.........................................................................................#....
....#.........................................................................................#....
....#.........................................................................................#....
....#.........................................................................................#....
....#.........................................................................................#....
....#.........................................................................................#....
....#.........................................................................................#....
....#.........................................................................................#....
....#.........................................................................................#....
....#.........................................................................................#....
....#.........................................................................................#....
....#.........................................................................................#....
....#.........................................................................................#....
....###########################################################################################....
...................................................................................................
...................................................................................................
