...................................................................................................
...................................................................................................
....###########################################################################################....
....#.........................................................................................#....
....#.........................................................................................#....
....#.........................................................................................#....
....#.........................................................................................#....
....#.........................................................................................#....
....#.........................................................................................#....
....#........o................................................................................#....
....#.........................................................................................#....
....#.........................................................................................#....
....#.........................................................................................#....
....#.........................................................................................#....
....#.........................................................................................#....
....#.........................................................................................#....
....#.........................................................................................#....
....#.........................................................................#...............#....
....#............................................................#............................#....
....#....................................................................#............#.......#....
....#......................................................#..................................#....
....#.........................................................................................#....
....#.............................................#...........................................#....
....#.........................................................................................#....
....#.........................................................................................#....
....#.........................................#...............................................#....
....#.........................................................................................#....
....#.........................................................................................#....
....#.............................................#...........................................#....
....#.........................................................................................#....
....#.........................................................................@...............#....
....#..........................................#..............................................#....
....#.........................................................................................#....
....#...............................................#.........................................#....
....#.........................................................................................#....
....#.........................................................................................#....
....###########################################################################################....
...................................................................................................
...................................................................................................
