...................................................................................................
...................................................................................................
....###########################################################################################....
....#..........#..............................................................................#....
....#..........#..............................................................................#....
....#..........#..............................................................................#....
....#.o........#..............................................................................#....
....#..........#..............................................................................#....
....#..........#...........................................##.................................#....
....#..........#.......#...................................##...........##....................#....
....#..........#.......#................................................##....................#....
....#..........#.......#.................##.............................##....................#....
....#..........#.......#.................##.........................##########................#....
....#..........#.......#............................................##########................#....
....#..........#.......#.............................####...............##....................#....
....#..........#.......#.............................####...............##....................#....
....#..........#.......#.............................####...............##....................#....
....#..........#.......#...................##.................................................#....
....#..........#.......#...................##.....................................########....#....
....#..........#.......#..........................................................########....#....
....#..........#.......#......................................................................#....
....#..........#.......#......................................................................#....
....#..........#.......#......................................................................#....
....#..........#.......#....................................##................................#....
....#..........#.......#....................................##................................#....
....#..........#.......#......................................................................#....
....#..........#.......#...............................................#############..........#....
....#..........#.......#...............................................#......................#....
....#..................#........................##.....................#......................#....
....#..................#........................##.....................#.....@................#....
....#..................#...............................................#......................#....
....#..................#...............................................#......................#....
....#..................#...............................................#......................#....
....#..................#......................................................................#....
....#..................#......................................................................#....
....#..................#......................................................................#....
....###########################################################################################....
...................................................................................................
...................................................................................................
